5 2 2 5 5 5 5 5 5 5 5 5 5 4 2 2 2 4
5 -1 0 5 5 0 0 0 0 3 0 0 0 4 0 0 0 4
5 0 0 5 0 0 3 0 0 5 0 0 5 4 0 0 0 4
5 0 0 0 0 0 3 0 0 5 0 0 5 4 0 0 0 4
5 0 3 3 3 3 3 0 0 5 0 5 5 5 0 0 0 4
5 0 3 0 0 0 3 0 0 0 0 0 0 0 0 0 0 4
5 0 0 0 0 0 3 3 3 3 0 0 0 0 3 3 3 3
5 0 3 3 3 0 0 0 0 0 0 0 0 0 3 0 0 3
5 0 3 0 0 0 0 0 0 0 5 5 5 5 0 0 0 3
5 0 3 3 3 3 0 0 0 0 5 5 5 0 0 0 0 3
5 0 0 0 0 3 3 3 3 0 0 0 0 0 0 0 0 3
5 0 3 3 3 3 0 0 0 0 0 0 0 0 0 0 0 3
5 0 0 0 0 3 0 0 0 3 0 0 0 0 0 0 0 3
5 1 5 5 0 3 3 3 0 3 3 3 0 3 3 3 3 3
5 2 2 5 0 0 5 5 0 5 5 5 0 4 2 2 2 4
5 2 0 5 5 0 0 0 0 3 0 0 0 4 0 0 0 4
5 0 0 5 0 0 3 0 0 5 0 0 5 4 0 0 0 4
5 0 0 0 0 0 3 0 0 5 0 0 5 4 0 0 0 4
5 0 3 3 3 3 3 0 0 1 0 5 5 5 0 0 0 4
5 0 1 0 0 0 3 0 0 0 0 0 0 0 0 0 0 4
5 0 0 0 0 0 e 3 3 3 0 0 0 0 3 3 3 3
5 0 1 3 3 3 3 0 0 0 0 0 0 0 3 0 0 3
5 0 3 0 0 0 0 0 0 0 1 5 5 0 0 0 0 3
5 0 3 3 3 3 0 0 0 0 5 5 5 0 0 0 0 3
5 0 0 0 0 3 3 3 3 0 0 0 0 0 0 0 0 3
5 0 1 3 0 0 0 0 0 0 0 3 0 5 0 0 0 3
5 0 0 0 0 3 0 0 0 1 0 0 0 0 0 0 0 3
5 5 5 5 5 3 3 3 3 3 3 3 3 3 3 3 3 3
